1111111111111
1P0000CC000E1
1111111111111